"Year","Rank","DonorName","DonorNameWithFlag","Iso3","Iso2","Earmarked","UnEarmarked","Total"
2008,"1","Sweden",":se: Sweden","swe","se","13207678","12540749","25748427"
2008,"2","Norway",":no: Norway","nor","no","6921313","9809127","16730440"
2008,"3","United Kingdom",":gb: United Kingdom","gbr","gb","3721692","10786749","14508441"
2008,"4","United States",":us: United States","usa","us","10629662","3225700","13855362"
2008,"5","European Commission","European Commission","eu","","11569296","0","11569296"
2008,"6","Ireland",":ie: Ireland","irl","ie","4825999","2336449","7162448"
2008,"7","Australia",":au: Australia","aus","au","2507487","3841600","6349087"
2008,"8","Canada",":ca: Canada","can","ca","5268762","972857","6241619"
2008,"9","Netherlands",":nl: Netherlands","nld","nl","3107961","2785817","5893778"
2008,"10","Multi-Donor Funds","Multi-Donor Funds","a","","4636740","0","4636740"
2008,"11","Spain",":es: Spain","esp","es","4362176","0","4362176"
2008,"12","Finland",":fi: Finland","fin","fi","0","3844081","3844081"
2008,"13","Switzerland",":ch: Switzerland","che","ch","3148800","598201","3747001"
2008,"14","New Zealand",":nz: New Zealand","nzl","nz","0","3407763","3407763"
2008,"15","Japan",":jp: Japan","jpn","jp","464125","2023806","2487931"
2008,"16","Germany",":de: Germany","deu","de","1478910","813609","2292519"
2008,"17","Denmark",":dk: Denmark","dnk","dk","0","1992945","1992945"
2008,"18","Luxembourg",":lu: Luxembourg","lux","lu","653417","1313382","1966799"
2008,"19","France",":fr: France","fra","fr","35378","1479290","1514668"
2008,"20","Belgium",":be: Belgium","bel","be","540155","776194","1316349"
2008,"21","United Arab Emirates",":ae: United Arab Emirates","are","ae","849960","0","849960"
2008,"22","Korea, Republic of",":kr: Korea, Republic of","kor","kr","700000","0","700000"
2008,"23","UN, NGOs and other entities","UN, NGOs and other entities","un","","659570","0","659570"
2008,"24","Morocco",":ma: Morocco","mar","ma","500000","0","500000"
2008,"24","Türkiye",":tr: Türkiye","tur","tr","500000","0","500000"
2008,"26","Austria",":at: Austria","aut","at","107272","94637","201909"
2008,"27","Italy",":it: Italy","ita","it","188502","0","188502"
2008,"28","Iceland",":is: Iceland","isl","is","139341","0","139341"
2008,"29","Czech Republic",":cz: Czech Republic","cze","cz","0","138487","138487"
2008,"30","Private Contributions","Private Contributions","pri_con","","85863","0","85863"
2008,"31","Malta",":mt: Malta","mlt","mt","69984","0","69984"
2008,"32","Singapore",":sg: Singapore","sgp","sg","30000","20000","50000"
2008,"33","Monaco",":mc: Monaco","mco","mc","0","38772","38772"
2008,"34","Lithuania",":lt: Lithuania","ltu","lt","31949","0","31949"
2008,"35","Latvia",":lv: Latvia","lva","lv","31104","0","31104"
2008,"36","Slovenia",":si: Slovenia","svn","si","0","25000","25000"
2008,"37","Greece",":gr: Greece","grc","gr","0","21459","21459"
2008,"38","Estonia",":ee: Estonia","est","ee","0","18705","18705"
2008,"39","Philippines",":ph: Philippines","phl","ph","15742","0","15742"
2008,"40","Chile",":cl: Chile","chl","cl","10000","0","10000"
2008,"41","South Africa",":za: South Africa","zaf","za","6154","0","6154"
2009,"1","Sweden",":se: Sweden","swe","se","11659543","10712880","22372423"
2009,"2","United Kingdom",":gb: United Kingdom","gbr","gb","6717258","12831157","19548415"
2009,"3","United States",":us: United States","usa","us","14752596","3000001","17752597"
2009,"4","European Commission","European Commission","eu","","17695239","0","17695239"
2009,"5","Norway",":no: Norway","nor","no","3471532","7006432","10477964"
2009,"6","Netherlands",":nl: Netherlands","nld","nl","3367353","3941146","7308499"
2009,"7","Canada",":ca: Canada","can","ca","5840522","807037","6647559"
2009,"8","Finland",":fi: Finland","fin","fi","274822","5725433","6000255"
2009,"9","Australia",":au: Australia","aus","au","2417905","3246000","5663905"
2009,"10","Ireland",":ie: Ireland","irl","ie","3445786","1450362","4896148"
2009,"11","Switzerland",":ch: Switzerland","che","ch","2536264","1210801","3747065"
2009,"12","New Zealand",":nz: New Zealand","nzl","nz","0","3487070","3487070"
2009,"13","Spain",":es: Spain","esp","es","3181638","0","3181638"
2009,"14","Germany",":de: Germany","deu","de","1772214","1331163","3103377"
2009,"15","Belgium",":be: Belgium","bel","be","1433284","1406469","2839753"
2009,"16","Italy",":it: Italy","ita","it","2532533","0","2532533"
2009,"17","Denmark",":dk: Denmark","dnk","dk","751796","1740177","2491973"
2009,"18","Japan",":jp: Japan","jpn","jp","450000","2037933","2487933"
2009,"19","Multi-Donor Funds","Multi-Donor Funds","a","","1444650","0","1444650"
2009,"20","France",":fr: France","fra","fr","0","1278772","1278772"
2009,"21","Luxembourg",":lu: Luxembourg","lux","lu","0","924394","924394"
2009,"22","Türkiye",":tr: Türkiye","tur","tr","700000","0","700000"
2009,"23","Korea, Republic of",":kr: Korea, Republic of","kor","kr","0","300000","300000"
2009,"24","United Arab Emirates",":ae: United Arab Emirates","are","ae","0","299975","299975"
2009,"25","UN, NGOs and other entities","UN, NGOs and other entities","un","","188138","0","188138"
2009,"26","Iceland",":is: Iceland","isl","is","100000","71000","171000"
2009,"27","Austria",":at: Austria","aut","at","76592","86331","162923"
2009,"28","Singapore",":sg: Singapore","sgp","sg","49975","20000","69975"
2009,"29","Private Contributions","Private Contributions","pri_con","","40294","44","40338"
2009,"30","Monaco",":mc: Monaco","mco","mc","0","39683","39683"
2009,"31","Estonia",":ee: Estonia","est","ee","0","32372","32372"
2009,"32","Greece",":gr: Greece","grc","gr","0","28860","28860"
2009,"33","Slovenia",":si: Slovenia","svn","si","0","27924","27924"
2009,"34","Philippines",":ph: Philippines","phl","ph","20000","0","20000"
2009,"35","Andorra",":ad: Andorra","and","ad","11095","0","11095"
2009,"36","Slovakia",":sk: Slovakia","svk","sk","0","10538","10538"
2009,"37","Nicaragua",":ni: Nicaragua","nic","ni","5000","0","5000"
2009,"38","Bahamas",":bs: Bahamas","bhs","bs","0","2000","2000"
2010,"1","Sweden",":se: Sweden","swe","se","10841596","16859907","27701503"
2010,"2","United States",":us: United States","usa","us","17630000","4050000","21680000"
2010,"3","European Commission","European Commission","eu","","19865508","0","19865508"
2010,"4","Norway",":no: Norway","nor","no","7096900","12657794","19754694"
2010,"5","United Kingdom",":gb: United Kingdom","gbr","gb","3135024","11146496","14281520"
2010,"6","Australia",":au: Australia","aus","au","4196445","6235401","10431846"
2010,"7","Netherlands",":nl: Netherlands","nld","nl","5343","6993007","6998350"
2010,"8","Canada",":ca: Canada","can","ca","5992341","973141","6965482"
2010,"9","Japan",":jp: Japan","jpn","jp","2950000","2037931","4987931"
2010,"10","Switzerland",":ch: Switzerland","che","ch","3349712","1419056","4768768"
2010,"11","Ireland",":ie: Ireland","irl","ie","3332952","1349528","4682480"
2010,"12","Germany",":de: Germany","deu","de","3326182","1318681","4644863"
2010,"13","New Zealand",":nz: New Zealand","nzl","nz","0","4312801","4312801"
2010,"14","Finland",":fi: Finland","fin","fi","202429","4048583","4251012"
2010,"15","Denmark",":dk: Denmark","dnk","dk","463876","3489502","3953378"
2010,"16","Austria",":at: Austria","aut","at","2898672","139417","3038089"
2010,"17","Multi-Donor Funds","Multi-Donor Funds","a","","2562604","0","2562604"
2010,"18","Spain",":es: Spain","esp","es","2489363","0","2489363"
2010,"19","Russian Federation",":ru: Russian Federation","rus","ru","1500000","639000","2139000"
2010,"20","Belgium",":be: Belgium","bel","be","694444","1233046","1927490"
2010,"21","Italy",":it: Italy","ita","it","1408314","0","1408314"
2010,"22","France",":fr: France","fra","fr","269906","1079622","1349528"
2010,"23","Luxembourg",":lu: Luxembourg","lux","lu","0","1079456","1079456"
2010,"24","Korea, Republic of",":kr: Korea, Republic of","kor","kr","300000","500000","800000"
2010,"25","United Arab Emirates",":ae: United Arab Emirates","are","ae","249975","499975","749950"
2010,"26","Brazil",":br: Brazil","bra","br","545000","0","545000"
2010,"27","Turkmenistan",":tm: Turkmenistan","tkm","tm","500000","0","500000"
2010,"27","Timor-Leste",":tl: Timor-Leste","tls","tl","500000","0","500000"
2010,"29","Iceland",":is: Iceland","isl","is","0","300000","300000"
2010,"30","Türkiye",":tr: Türkiye","tur","tr","250000","0","250000"
2010,"31","Greece",":gr: Greece","grc","gr","164766","0","164766"
2010,"32","Poland",":pl: Poland","pol","pl","0","103000","103000"
2010,"33","Kuwait",":kw: Kuwait","kwt","kw","100000","0","100000"
2010,"33","Malaysia",":my: Malaysia","mys","my","100000","0","100000"
2010,"35","Azerbaijan",":az: Azerbaijan","aze","az","99978","0","99978"
2010,"36","Singapore",":sg: Singapore","sgp","sg","50000","20000","70000"
2010,"37","Private Contributions","Private Contributions","pri_con","","50346","300","50646"
2010,"38","Portugal",":pt: Portugal","prt","pt","50000","0","50000"
2010,"38","Philippines",":ph: Philippines","phl","ph","50000","0","50000"
2010,"38","Congo",":cg: Congo","cog","cg","50000","0","50000"
2010,"41","Monaco",":mc: Monaco","mco","mc","0","46748","46748"
2010,"42","Estonia",":ee: Estonia","est","ee","0","38243","38243"
2010,"43","Bahamas",":bs: Bahamas","bhs","bs","0","2000","2000"
2010,"44","Afghanistan",":af: Afghanistan","afg","af","0","100","100"
2011,"1","United Kingdom",":gb: United Kingdom","gbr","gb","2815595","37526414","40342009"
2011,"2","Sweden",":se: Sweden","swe","se","13983217","18792080","32775297"
2011,"3","United States",":us: United States","usa","us","23105704","3940000","27045704"
2011,"4","Norway",":no: Norway","nor","no","8472393","15726790","24199183"
2011,"5","European Commission","European Commission","eu","","17304618","0","17304618"
2011,"6","Australia",":au: Australia","aus","au","1067014","7013985","8080999"
2011,"7","Canada",":ca: Canada","can","ca","5987295","1013625","7000920"
2011,"8","Netherlands",":nl: Netherlands","nld","nl","0","6250000","6250000"
2011,"9","Spain",":es: Spain","esp","es","5633800","0","5633800"
2011,"10","Switzerland",":ch: Switzerland","che","ch","4219972","1051525","5271497"
2011,"11","Japan",":jp: Japan","jpn","jp","2820000","1919138","4739138"
2011,"12","New Zealand",":nz: New Zealand","nzl","nz","0","4574400","4574400"
2011,"13","Finland",":fi: Finland","fin","fi","0","4120879","4120879"
2011,"14","Germany",":de: Germany","deu","de","2569212","1365201","3934413"
2011,"15","Ireland",":ie: Ireland","irl","ie","1612941","2214690","3827631"
2011,"16","Denmark",":dk: Denmark","dnk","dk","0","3674135","3674135"
2011,"17","Belgium",":be: Belgium","bel","be","1333334","1481481","2814815"
2011,"18","Russian Federation",":ru: Russian Federation","rus","ru","1100000","800000","1900000"
2011,"19","France",":fr: France","fra","fr","285307","1185185","1470492"
2011,"20","United Arab Emirates",":ae: United Arab Emirates","are","ae","1252330","20000","1272330"
2011,"21","India",":in: India","ind","in","1000000","0","1000000"
2011,"22","Luxembourg",":lu: Luxembourg","lux","lu","0","993964","993964"
2011,"23","Italy",":it: Italy","ita","it","666667","0","666667"
2011,"24","Poland",":pl: Poland","pol","pl","437025","113208","550233"
2011,"25","Multi-Donor Funds","Multi-Donor Funds","a","","527918","0","527918"
2011,"26","Korea, Republic of",":kr: Korea, Republic of","kor","kr","0","500000","500000"
2011,"27","Austria",":at: Austria","aut","at","274348","154930","429278"
2011,"28","South Africa",":za: South Africa","zaf","za","136240","0","136240"
2011,"29","Congo",":cg: Congo","cog","cg","125949","0","125949"
2011,"30","Czech Republic",":cz: Czech Republic","cze","cz","0","112568","112568"
2011,"31","Iceland",":is: Iceland","isl","is","0","103212","103212"
2011,"32","Chile",":cl: Chile","chl","cl","100000","0","100000"
2011,"33","Hungary",":hu: Hungary","hun","hu","50000","10667","60667"
2011,"34","Liechtenstein",":li: Liechtenstein","lie","li","56561","0","56561"
2011,"35","Andorra",":ad: Andorra","and","ad","56533","0","56533"
2011,"36","Qatar",":qa: Qatar","qat","qa","55000","0","55000"
2011,"37","Monaco",":mc: Monaco","mco","mc","0","53426","53426"
2011,"38","Estonia",":ee: Estonia","est","ee","0","35506","35506"
2011,"39","Guyana",":gy: Guyana","guy","gy","25000","0","25000"
2011,"40","Kazakhstan",":kz: Kazakhstan","kaz","kz","24964","0","24964"
2011,"41","Singapore",":sg: Singapore","sgp","sg","0","20000","20000"
2011,"42","Greece",":gr: Greece","grc","gr","0","19711","19711"
2011,"43","Slovenia",":si: Slovenia","svn","si","14306","0","14306"
2011,"44","Private Contributions","Private Contributions","pri_con","","1218","0","1218"
2011,"45","Afghanistan",":af: Afghanistan","afg","af","0","1000","1000"
2012,"1","United Kingdom",":gb: United Kingdom","gbr","gb","1266870","37284087","38550957"
2012,"2","Sweden",":se: Sweden","swe","se","14895923","19535250","34431173"
2012,"3","United States",":us: United States","usa","us","24423348","4000000","28423348"
2012,"4","European Commission","European Commission","eu","","25422414","0","25422414"
2012,"5","Norway",":no: Norway","nor","no","6927007","15003754","21930761"
2012,"6","Australia",":au: Australia","aus","au","6199320","8320800","14520120"
2012,"7","Canada",":ca: Canada","can","ca","6983007","1016689","7999696"
2012,"8","Netherlands",":nl: Netherlands","nld","nl","0","7142857","7142857"
2012,"9","Japan",":jp: Japan","jpn","jp","4920000","2052428","6972428"
2012,"10","Denmark",":dk: Denmark","dnk","dk","0","5389388","5389388"
2012,"11","Switzerland",":ch: Switzerland","che","ch","3529016","1595835","5124851"
2012,"12","Germany",":de: Germany","deu","de","3158094","1932507","5090601"
2012,"13","New Zealand",":nz: New Zealand","nzl","nz","0","5038175","5038175"
2012,"14","Finland",":fi: Finland","fin","fi","0","3931848","3931848"
2012,"15","Spain",":es: Spain","esp","es","3925354","0","3925354"
2012,"16","Ireland",":ie: Ireland","irl","ie","2520757","1324503","3845260"
2012,"17","Russian Federation",":ru: Russian Federation","rus","ru","1900000","500000","2400000"
2012,"18","Belgium",":be: Belgium","bel","be","497345","1326258","1823603"
2012,"19","Austria",":at: Austria","aut","at","1616988","146082","1763070"
2012,"20","France",":fr: France","fra","fr","0","1328021","1328021"
2012,"21","Luxembourg",":lu: Luxembourg","lux","lu","0","928207","928207"
2012,"22","Italy",":it: Italy","ita","it","703461","0","703461"
2012,"23","Korea, Republic of",":kr: Korea, Republic of","kor","kr","100000","500000","600000"
2012,"24","Poland",":pl: Poland","pol","pl","410663","93691","504354"
2012,"25","United Arab Emirates",":ae: United Arab Emirates","are","ae","249975","20000","269975"
2012,"26","Kazakhstan",":kz: Kazakhstan","kaz","kz","0","199929","199929"
2012,"27","Cyprus",":cy: Cyprus","cyp","cy","129198","0","129198"
2012,"28","Czech Republic",":cz: Czech Republic","cze","cz","0","99895","99895"
2012,"29","Andorra",":ad: Andorra","and","ad","69959","0","69959"
2012,"30","Estonia",":ee: Estonia","est","ee","0","64802","64802"
2012,"31","Liechtenstein",":li: Liechtenstein","lie","li","55127","0","55127"
2012,"32","Monaco",":mc: Monaco","mco","mc","0","53121","53121"
2012,"33","Malta",":mt: Malta","mlt","mt","33699","0","33699"
2012,"34","Argentina",":ar: Argentina","arg","ar","27326","0","27326"
2012,"35","Singapore",":sg: Singapore","sgp","sg","0","20000","20000"
2012,"36","Chile",":cl: Chile","chl","cl","15000","0","15000"
2012,"37","Hungary",":hu: Hungary","hun","hu","0","9804","9804"
2012,"38","Afghanistan",":af: Afghanistan","afg","af","0","1000","1000"
2013,"1","Sweden",":se: Sweden","swe","se","16089175","19307200","35396375"
2013,"2","United Kingdom",":gb: United Kingdom","gbr","gb","2350829","31234772","33585601"
2013,"3","United States",":us: United States","usa","us","27174402","3568529","30742931"
2013,"4","European Commission","European Commission","eu","","21372513","0","21372513"
2013,"5","Norway",":no: Norway","nor","no","8935498","11287985","20223483"
2013,"6","Australia",":au: Australia","aus","au","4495450","9424800","13920250"
2013,"7","Switzerland",":ch: Switzerland","che","ch","7824155","2096436","9920591"
2013,"8","Canada",":ca: Canada","can","ca","7584948","992950","8577898"
2013,"9","Japan",":jp: Japan","jpn","jp","5420000","2052428","7472428"
2013,"10","Netherlands",":nl: Netherlands","nld","nl","0","6250000","6250000"
2013,"11","Germany",":de: Germany","deu","de","3715835","1972031","5687866"
2013,"12","Denmark",":dk: Denmark","dnk","dk","0","5337964","5337964"
2013,"13","Spain",":es: Spain","esp","es","5215203","0","5215203"
2013,"14","Finland",":fi: Finland","fin","fi","719825","3978780","4698605"
2013,"15","New Zealand",":nz: New Zealand","nzl","nz","0","4280690","4280690"
2013,"16","Ireland",":ie: Ireland","irl","ie","929932","3267132","4197064"
2013,"17","Belgium",":be: Belgium","bel","be","1506045","1356852","2862897"
2013,"18","Russian Federation",":ru: Russian Federation","rus","ru","950000","500000","1450000"
2013,"19","France",":fr: France","fra","fr","0","1308901","1308901"
2013,"20","Luxembourg",":lu: Luxembourg","lux","lu","135685","916230","1051915"
2013,"21","Korea, Republic of",":kr: Korea, Republic of","kor","kr","500000","500000","1000000"
2013,"22","Italy",":it: Italy","ita","it","685542","0","685542"
2013,"23","Poland",":pl: Poland","pol","pl","290839","257904","548743"
2013,"24","United Arab Emirates",":ae: United Arab Emirates","are","ae","0","520000","520000"
2013,"25","Austria",":at: Austria","aut","at","271739","149254","420993"
2013,"26","Multi-Donor Funds","Multi-Donor Funds","a","","258638","0","258638"
2013,"27","Colombia",":co: Colombia","col","co","150000","0","150000"
2013,"28","Iceland",":is: Iceland","isl","is","0","100000","100000"
2013,"29","Kazakhstan",":kz: Kazakhstan","kaz","kz","99970","0","99970"
2013,"30","Czech Republic",":cz: Czech Republic","cze","cz","0","61851","61851"
2013,"31","Estonia",":ee: Estonia","est","ee","0","61133","61133"
2013,"32","Malta",":mt: Malta","mlt","mt","54348","0","54348"
2013,"33","Monaco",":mc: Monaco","mco","mc","0","52151","52151"
2013,"34","Hungary",":hu: Hungary","hun","hu","0","26178","26178"
2013,"35","Singapore",":sg: Singapore","sgp","sg","0","20000","20000"
2013,"36","Lithuania",":lt: Lithuania","ltu","lt","0","19096","19096"
2013,"37","Andorra",":ad: Andorra","and","ad","13569","0","13569"
2013,"38","Afghanistan",":af: Afghanistan","afg","af","0","1000","1000"
2013,"38","Namibia",":na: Namibia","nam","na","0","1000","1000"
2014,"1","United Kingdom",":gb: United Kingdom","gbr","gb","7896628","32845062","40741690"
2014,"2","Sweden",":se: Sweden","swe","se","15149600","16159538","31309138"
2014,"3","United States",":us: United States","usa","us","26140865","3919150","30060015"
2014,"4","European Commission","European Commission","eu","","23581061","0","23581061"
2014,"5","Norway",":no: Norway","nor","no","5214087","11625534","16839621"
2014,"6","Australia",":au: Australia","aus","au","3780959","8103600","11884559"
2014,"7","Switzerland",":ch: Switzerland","che","ch","6898328","2217295","9115623"
2014,"8","Canada",":ca: Canada","can","ca","7835610","896379","8731989"
2014,"9","Germany",":de: Germany","deu","de","5937701","1981895","7919596"
2014,"10","Netherlands",":nl: Netherlands","nld","nl","0","6353240","6353240"
2014,"11","Japan",":jp: Japan","jpn","jp","5132000","983896","6115896"
2014,"12","Denmark",":dk: Denmark","dnk","dk","0","5507329","5507329"
2014,"13","Finland",":fi: Finland","fin","fi","187735","4070556","4258291"
2014,"14","New Zealand",":nz: New Zealand","nzl","nz","0","4172472","4172472"
2014,"15","Saudi Arabia",":sa: Saudi Arabia","sau","sa","3584025","0","3584025"
2014,"16","Kuwait",":kw: Kuwait","kwt","kw","3000000","0","3000000"
2014,"17","Ireland",":ie: Ireland","irl","ie","267380","2673797","2941177"
2014,"18","Belgium",":be: Belgium","bel","be","0","2788104","2788104"
2014,"19","United Arab Emirates",":ae: United Arab Emirates","are","ae","1363925","1019975","2383900"
2014,"20","France",":fr: France","fra","fr","0","1375516","1375516"
2014,"21","Luxembourg",":lu: Luxembourg","lux","lu","0","957679","957679"
2014,"22","Russian Federation",":ru: Russian Federation","rus","ru","450000","500000","950000"
2014,"23","Korea, Republic of",":kr: Korea, Republic of","kor","kr","400000","500000","900000"
2014,"24","Estonia",":ee: Estonia","est","ee","645510","206612","852122"
2014,"25","Spain",":es: Spain","esp","es","566893","0","566893"
2014,"26","Italy",":it: Italy","ita","it","553097","0","553097"
2014,"27","Poland",":pl: Poland","pol","pl","452989","26083","479072"
2014,"28","Türkiye",":tr: Türkiye","tur","tr","0","453886","453886"
2014,"29","Private Contributions","Private Contributions","pri_con","","298880","510","299390"
2014,"30","UN, NGOs and other entities","UN, NGOs and other entities","un","","240222","0","240222"
2014,"31","Multi-Donor Funds","Multi-Donor Funds","a","","231433","0","231433"
2014,"32","Austria",":at: Austria","aut","at","0","122449","122449"
2014,"33","Iceland",":is: Iceland","isl","is","0","100000","100000"
2014,"34","Argentina",":ar: Argentina","arg","ar","90000","0","90000"
2014,"35","Guyana",":gy: Guyana","guy","gy","60267","0","60267"
2014,"36","Kazakhstan",":kz: Kazakhstan","kaz","kz","0","49970","49970"
2014,"37","Cyprus",":cy: Cyprus","cyp","cy","25221","0","25221"
2014,"38","Monaco",":mc: Monaco","mco","mc","0","21668","21668"
2014,"39","Singapore",":sg: Singapore","sgp","sg","0","20000","20000"
2015,"1","United Kingdom",":gb: United Kingdom","gbr","gb","12526766","30899547","43426313"
2015,"2","United States",":us: United States","usa","us","36030450","3770012","39800462"
2015,"3","Sweden",":se: Sweden","swe","se","11407784","14029162","25436946"
2015,"4","European Commission","European Commission","eu","","18393960","0","18393960"
2015,"5","Norway",":no: Norway","nor","no","4665524","9256103","13921627"
2015,"6","Australia",":au: Australia","aus","au","1586271","7592919","9179190"
2015,"7","Japan",":jp: Japan","jpn","jp","7920000","856081","8776081"
2015,"8","Switzerland",":ch: Switzerland","che","ch","6323196","2096436","8419632"
2015,"9","Germany",":de: Germany","deu","de","6527354","1687289","8214643"
2015,"10","Saudi Arabia",":sa: Saudi Arabia","sau","sa","7999950","0","7999950"
2015,"11","Netherlands",":nl: Netherlands","nld","nl","2293660","5417118","7710778"
2015,"12","Canada",":ca: Canada","can","ca","3398216","1593499","4991715"
2015,"13","Denmark",":dk: Denmark","dnk","dk","69229","4725176","4794405"
2015,"14","New Zealand",":nz: New Zealand","nzl","nz","0","3975035","3975035"
2015,"15","Finland",":fi: Finland","fin","fi","0","3791983","3791983"
2015,"16","Belgium",":be: Belgium","bel","be","1220174","2437703","3657877"
2015,"17","Ireland",":ie: Ireland","irl","ie","219780","2760635","2980415"
2015,"18","Kuwait",":kw: Kuwait","kwt","kw","2500000","0","2500000"
2015,"19","Korea, Republic of",":kr: Korea, Republic of","kor","kr","500000","1000000","1500000"
2015,"20","United Arab Emirates",":ae: United Arab Emirates","are","ae","355912","999950","1355862"
2015,"21","France",":fr: France","fra","fr","0","1122334","1122334"
2015,"22","Morocco",":ma: Morocco","mar","ma","1000000","0","1000000"
2015,"22","Russian Federation",":ru: Russian Federation","rus","ru","0","1000000","1000000"
2015,"22","Thailand",":th: Thailand","tha","th","1000000","0","1000000"
2015,"22","Türkiye",":tr: Türkiye","tur","tr","500000","500000","1000000"
2015,"26","Luxembourg",":lu: Luxembourg","lux","lu","0","824103","824103"
2015,"27","Estonia",":ee: Estonia","est","ee","692721","109890","802611"
2015,"28","Spain",":es: Spain","esp","es","0","546448","546448"
2015,"29","Austria",":at: Austria","aut","at","441020","95440","536460"
2015,"30","Azerbaijan",":az: Azerbaijan","aze","az","500000","0","500000"
2015,"31","Poland",":pl: Poland","pol","pl","472037","0","472037"
2015,"32","Trinidad and Tobago",":tt: Trinidad and Tobago","tto","tt","250000","0","250000"
2015,"33","Private Contributions","Private Contributions","pri_con","","132700","0","132700"
2015,"34","South Africa",":za: South Africa","zaf","za","118362","0","118362"
2015,"35","Iceland",":is: Iceland","isl","is","0","100000","100000"
2015,"36","Czech Republic",":cz: Czech Republic","cze","cz","0","84098","84098"
2015,"37","Malaysia",":my: Malaysia","mys","my","40000","0","40000"
2015,"37","Singapore",":sg: Singapore","sgp","sg","0","40000","40000"
2015,"39","Monaco",":mc: Monaco","mco","mc","0","27199","27199"
2015,"40","Andorra",":ad: Andorra","and","ad","16269","0","16269"
2015,"41","UN, NGOs and other entities","UN, NGOs and other entities","un","","15000","0","15000"
2015,"42","Afghanistan",":af: Afghanistan","afg","af","1000","0","1000"
2016,"1","United States",":us: United States","usa","us","45620000","3633424","49253424"
2016,"2","United Kingdom",":gb: United Kingdom","gbr","gb","10484426","31555282","42039708"
2016,"3","Sweden",":se: Sweden","swe","se","21801012","15362342","37163354"
2016,"4","European Commission","European Commission","eu","","21241050","0","21241050"
2016,"5","Germany",":de: Germany","deu","de","13004877","2393836","15398713"
2016,"6","Norway",":no: Norway","nor","no","6428095","8311987","14740082"
2016,"7","Switzerland",":ch: Switzerland","che","ch","7300968","1984127","9285095"
2016,"8","Japan",":jp: Japan","jpn","jp","8020000","658075","8678075"
2016,"9","Belgium",":be: Belgium","bel","be","5885649","2513966","8399615"
2016,"10","Australia",":au: Australia","aus","au","955987","6272207","7228194"
2016,"11","Canada",":ca: Canada","can","ca","4578168","1500488","6078656"
2016,"12","Netherlands",":nl: Netherlands","nld","nl","223090","5574136","5797226"
2016,"13","Ireland",":ie: Ireland","irl","ie","514016","4957609","5471625"
2016,"14","Denmark",":dk: Denmark","dnk","dk","0","4441587","4441587"
2016,"15","Finland",":fi: Finland","fin","fi","0","3825137","3825137"
2016,"16","New Zealand",":nz: New Zealand","nzl","nz","0","3476684","3476684"
2016,"17","Spain",":es: Spain","esp","es","280269","1121076","1401345"
2016,"18","Korea, Republic of",":kr: Korea, Republic of","kor","kr","350000","1000000","1350000"
2016,"19","France",":fr: France","fra","fr","0","1133787","1133787"
2016,"20","Russian Federation",":ru: Russian Federation","rus","ru","350000","500000","850000"
2016,"21","Luxembourg",":lu: Luxembourg","lux","lu","0","809739","809739"
2016,"22","Austria",":at: Austria","aut","at","554936","98684","653620"
2016,"23","Poland",":pl: Poland","pol","pl","545791","0","545791"
2016,"24","Türkiye",":tr: Türkiye","tur","tr","0","500000","500000"
2016,"25","Estonia",":ee: Estonia","est","ee","319738","0","319738"
2016,"26","Malta",":mt: Malta","mlt","mt","195192","0","195192"
2016,"27","UN, NGOs and other entities","UN, NGOs and other entities","un","","150579","0","150579"
2016,"28","Kazakhstan",":kz: Kazakhstan","kaz","kz","100000","50000","150000"
2016,"29","Private Contributions","Private Contributions","pri_con","","100108","100","100208"
2016,"30","Thailand",":th: Thailand","tha","th","100000","0","100000"
2016,"30","Georgia",":ge: Georgia","geo","ge","100000","0","100000"
2016,"30","Iceland",":is: Iceland","isl","is","0","100000","100000"
2016,"33","Bulgaria",":bg: Bulgaria","bgr","bg","53079","0","53079"
2016,"33","Romania",":ro: Romania","rou","ro","53079","0","53079"
2016,"35","Singapore",":sg: Singapore","sgp","sg","50000","0","50000"
2016,"36","Czech Republic",":cz: Czech Republic","cze","cz","0","38171","38171"
2016,"37","Monaco",":mc: Monaco","mco","mc","0","27933","27933"
2016,"38","United Arab Emirates",":ae: United Arab Emirates","are","ae","5000","20000","25000"
2016,"39","Hungary",":hu: Hungary","hun","hu","0","22198","22198"
2016,"40","Philippines",":ph: Philippines","phl","ph","20000","0","20000"
2016,"41","Kuwait",":kw: Kuwait","kwt","kw","5000","0","5000"
2017,"1","United States",":us: United States","usa","us","44883161","3423037","48306198"
2017,"2","United Kingdom",":gb: United Kingdom","gbr","gb","5304622","25873221","31177843"
2017,"3","Sweden",":se: Sweden","swe","se","10908106","14090371","24998477"
2017,"4","Germany",":de: Germany","deu","de","16029539","2714441","18743980"
2017,"5","European Commission","European Commission","eu","","17813016","0","17813016"
2017,"6","Norway",":no: Norway","nor","no","6000387","8327493","14327880"
2017,"7","Qatar",":qa: Qatar","qat","qa","216211","9999965","10216176"
2017,"8","Netherlands",":nl: Netherlands","nld","nl","0","8239779","8239779"
2017,"9","Australia",":au: Australia","aus","au","1989777","6141207","8130984"
2017,"10","Canada",":ca: Canada","can","ca","6569032","1528430","8097462"
2017,"11","Denmark",":dk: Denmark","dnk","dk","3178422","4321882","7500304"
2017,"12","Switzerland",":ch: Switzerland","che","ch","4450580","1988072","6438652"
2017,"13","Japan",":jp: Japan","jpn","jp","5336900","856081","6192981"
2017,"14","Belgium",":be: Belgium","bel","be","2032520","2401281","4433801"
2017,"15","Ireland",":ie: Ireland","irl","ie","406724","3839897","4246621"
2017,"16","Finland",":fi: Finland","fin","fi","0","3661088","3661088"
2017,"17","New Zealand",":nz: New Zealand","nzl","nz","0","3455497","3455497"
2017,"18","Korea, Republic of",":kr: Korea, Republic of","kor","kr","1100000","1000000","2100000"
2017,"19","Spain",":es: Spain","esp","es","1176470","0","1176470"
2017,"20","France",":fr: France","fra","fr","0","1061571","1061571"
2017,"21","Malaysia",":my: Malaysia","mys","my","1000000","0","1000000"
2017,"22","Russian Federation",":ru: Russian Federation","rus","ru","480000","500000","980000"
2017,"23","Luxembourg",":lu: Luxembourg","lux","lu","0","944510","944510"
2017,"24","United Arab Emirates",":ae: United Arab Emirates","are","ae","249975","520000","769975"
2017,"25","Austria",":at: Austria","aut","at","542885","94142","637027"
2017,"26","Private Contributions","Private Contributions","pri_con","","575030","0","575030"
2017,"27","Estonia",":ee: Estonia","est","ee","452859","108696","561555"
2017,"28","Poland",":pl: Poland","pol","pl","502204","0","502204"
2017,"29","Türkiye",":tr: Türkiye","tur","tr","0","500000","500000"
2017,"30","Greece",":gr: Greece","grc","gr","360577","0","360577"
2017,"31","Slovakia",":sk: Slovakia","svk","sk","115233","236967","352200"
2017,"32","Iceland",":is: Iceland","isl","is","0","235000","235000"
2017,"33","Kuwait",":kw: Kuwait","kwt","kw","214449","0","214449"
2017,"34","Kazakhstan",":kz: Kazakhstan","kaz","kz","100000","50000","150000"
2017,"35","Thailand",":th: Thailand","tha","th","149835","0","149835"
2017,"36","UN, NGOs and other entities","UN, NGOs and other entities","un","","138479","0","138479"
2017,"37","Malta",":mt: Malta","mlt","mt","136206","0","136206"
2017,"38","Bulgaria",":bg: Bulgaria","bgr","bg","113531","0","113531"
2017,"39","Azerbaijan",":az: Azerbaijan","aze","az","50000","0","50000"
2017,"39","Argentina",":ar: Argentina","arg","ar","50000","0","50000"
2017,"41","Monaco",":mc: Monaco","mco","mc","0","26681","26681"
2017,"42","Saudi Arabia",":sa: Saudi Arabia","sau","sa","20000","0","20000"
2017,"42","Singapore",":sg: Singapore","sgp","sg","0","20000","20000"
2017,"44","Andorra",":ad: Andorra","and","ad","16287","0","16287"
2017,"45","Peru",":pe: Peru","per","pe","10319","0","10319"
2017,"46","Multi-Donor Funds","Multi-Donor Funds","a","","7697","0","7697"
2018,"1","United States",":us: United States","usa","us","44674000","3372349","48046349"
2018,"2","Sweden",":se: Sweden","swe","se","14040339","21344398","35384737"
2018,"3","United Kingdom",":gb: United Kingdom","gbr","gb","3807834","30080865","33888699"
2018,"4","Saudi Arabia",":sa: Saudi Arabia","sau","sa","12600000","9000000","21600000"
2018,"5","European Commission","European Commission","eu","","16286446","0","16286446"
2018,"6","Norway",":no: Norway","nor","no","4171417","11166643","15338060"
2018,"7","Germany",":de: Germany","deu","de","11547726","2988555","14536281"
2018,"8","Qatar",":qa: Qatar","qat","qa","0","9999970","9999970"
2018,"9","Canada",":ca: Canada","can","ca","8008356","1586703","9595059"
2018,"10","Australia",":au: Australia","aus","au","1225130","7116799","8341929"
2018,"11","Switzerland",":ch: Switzerland","che","ch","4330905","2059732","6390637"
2018,"12","Japan",":jp: Japan","jpn","jp","5088181","980000","6068181"
2018,"13","Netherlands",":nl: Netherlands","nld","nl","15332","6038647","6053979"
2018,"14","Denmark",":dk: Denmark","dnk","dk","0","4987263","4987263"
2018,"15","United Arab Emirates",":ae: United Arab Emirates","are","ae","4450000","20000","4470000"
2018,"16","Belgium",":be: Belgium","bel","be","1736111","2613240","4349351"
2018,"17","Finland",":fi: Finland","fin","fi","0","4181601","4181601"
2018,"18","Ireland",":ie: Ireland","irl","ie","566433","3580247","4146680"
2018,"19","New Zealand",":nz: New Zealand","nzl","nz","0","3530027","3530027"
2018,"20","Spain",":es: Spain","esp","es","2358492","0","2358492"
2018,"21","Korea, Republic of",":kr: Korea, Republic of","kor","kr","700000","1000000","1700000"
2018,"22","France",":fr: France","fra","fr","0","1226994","1226994"
2018,"23","Luxembourg",":lu: Luxembourg","lux","lu","0","1104294","1104294"
2018,"24","Russian Federation",":ru: Russian Federation","rus","ru","500000","500000","1000000"
2018,"25","Austria",":at: Austria","aut","at","568828","102273","671101"
2018,"26","Estonia",":ee: Estonia","est","ee","452897","186335","639232"
2018,"27","Italy",":it: Italy","ita","it","585480","0","585480"
2018,"28","Türkiye",":tr: Türkiye","tur","tr","0","500000","500000"
2018,"29","Poland",":pl: Poland","pol","pl","496797","0","496797"
2018,"30","Kazakhstan",":kz: Kazakhstan","kaz","kz","410000","0","410000"
2018,"31","Iceland",":is: Iceland","isl","is","100000","247427","347427"
2018,"32","Bulgaria",":bg: Bulgaria","bgr","bg","268087","0","268087"
2018,"33","Kuwait",":kw: Kuwait","kwt","kw","250000","0","250000"
2018,"34","Private Contributions","Private Contributions","pri_con","","76000","50","76050"
2018,"35","UN, NGOs and other entities","UN, NGOs and other entities","un","","60479","0","60479"
2018,"36","Romania",":ro: Romania","rou","ro","0","57870","57870"
2018,"37","Slovakia",":sk: Slovakia","svk","sk","38680","0","38680"
2018,"38","Monaco",":mc: Monaco","mco","mc","0","35842","35842"
2018,"39","Malta",":mt: Malta","mlt","mt","29274","0","29274"
2018,"40","Latvia",":lv: Latvia","lva","lv","22727","0","22727"
2019,"1","United States",":us: United States","usa","us","51611995","3376020","54988015"
2019,"2","Sweden",":se: Sweden","swe","se","13410398","20048279","33458677"
2019,"3","United Kingdom",":gb: United Kingdom","gbr","gb","4948900","24297376","29246276"
2019,"4","Germany",":de: Germany","deu","de","12665757","5646745","18312502"
2019,"5","Saudi Arabia",":sa: Saudi Arabia","sau","sa","15465224","500000","15965224"
2019,"6","Norway",":no: Norway","nor","no","4154336","10547144","14701480"
2019,"7","European Commission","European Commission","eu","","14663790","0","14663790"
2019,"8","Canada",":ca: Canada","can","ca","8622823","1544585","10167408"
2019,"9","Qatar",":qa: Qatar","qat","qa","0","9999970","9999970"
2019,"10","Netherlands",":nl: Netherlands","nld","nl","0","7658643","7658643"
2019,"11","Australia",":au: Australia","aus","au","716457","6448117","7164574"
2019,"12","Switzerland",":ch: Switzerland","che","ch","4829220","2004008","6833228"
2019,"13","Belgium",":be: Belgium","bel","be","3833333","2516779","6350112"
2019,"14","Japan",":jp: Japan","jpn","jp","4966427","850000","5816427"
2019,"15","Denmark",":dk: Denmark","dnk","dk","0","4552002","4552002"
2019,"16","Ireland",":ie: Ireland","irl","ie","523968","3185438","3709406"
2019,"17","Spain",":es: Spain","esp","es","3550983","0","3550983"
2019,"18","France",":fr: France","fra","fr","0","3423661","3423661"
2019,"19","New Zealand",":nz: New Zealand","nzl","nz","0","3420420","3420420"
2019,"20","Finland",":fi: Finland","fin","fi","0","2818489","2818489"
2019,"21","United Arab Emirates",":ae: United Arab Emirates","are","ae","250000","1499935","1749935"
2019,"22","Korea, Republic of",":kr: Korea, Republic of","kor","kr","700000","1000000","1700000"
2019,"23","Austria",":at: Austria","aut","at","1100110","103527","1203637"
2019,"24","Italy",":it: Italy","ita","it","1100111","0","1100111"
2019,"25","Luxembourg",":lu: Luxembourg","lux","lu","109409","892182","1001591"
2019,"26","Russian Federation",":ru: Russian Federation","rus","ru","270000","700000","970000"
2019,"27","Estonia",":ee: Estonia","est","ee","416852","167224","584076"
2019,"28","Türkiye",":tr: Türkiye","tur","tr","0","500000","500000"
2019,"29","Poland",":pl: Poland","pol","pl","491185","0","491185"
2019,"30","Portugal",":pt: Portugal","prt","pt","242025","55006","297031"
2019,"31","Iceland",":is: Iceland","isl","is","0","208855","208855"
2019,"32","UN, NGOs and other entities","UN, NGOs and other entities","un","","128632","0","128632"
2019,"33","Jersey",":je: Jersey","jey","je","121951","0","121951"
2019,"34","Bulgaria",":bg: Bulgaria","bgr","bg","111235","0","111235"
2019,"35","Private Contributions","Private Contributions","pri_con","","77047","0","77047"
2019,"36","Argentina",":ar: Argentina","arg","ar","0","70000","70000"
2019,"37","Singapore",":sg: Singapore","sgp","sg","0","39975","39975"
2019,"38","Monaco",":mc: Monaco","mco","mc","0","34247","34247"
2019,"39","Slovakia",":sk: Slovakia","svk","sk","22447","0","22447"
2019,"40","Romania",":ro: Romania","rou","ro","15000","0","15000"
2019,"41","Latvia",":lv: Latvia","lva","lv","11001","0","11001"
2019,"42","Philippines",":ph: Philippines","phl","ph","0","2500","2500"
2020,"1","United States",":us: United States","usa","us","46699651","3355422","50055073"
2020,"2","United Kingdom",":gb: United Kingdom","gbr","gb","3202349","32782520","35984869"
2020,"3","Sweden",":se: Sweden","swe","se","11674202","19598935","31273137"
2020,"4","Germany",":de: Germany","deu","de","19393258","5573399","24966657"
2020,"5","Norway",":no: Norway","nor","no","4293036","10077315","14370351"
2020,"6","European Commission","European Commission","eu","","13145681","0","13145681"
2020,"7","Canada",":ca: Canada","can","ca","9226051","1428918","10654969"
2020,"8","Denmark",":dk: Denmark","dnk","dk","0","10638268","10638268"
2020,"9","Qatar",":qa: Qatar","qat","qa","357980","9999970","10357950"
2020,"10","Switzerland",":ch: Switzerland","che","ch","5788160","2183406","7971566"
2020,"11","Netherlands",":nl: Netherlands","nld","nl","0","7918552","7918552"
2020,"12","Belgium",":be: Belgium","bel","be","0","7227642","7227642"
2020,"13","Australia",":au: Australia","aus","au","669965","6029689","6699654"
2020,"14","Japan",":jp: Japan","jpn","jp","4789923","861818","5651741"
2020,"15","Ireland",":ie: Ireland","irl","ie","634140","3619910","4254050"
2020,"16","Spain",":es: Spain","esp","es","4241339","0","4241339"
2020,"17","France",":fr: France","fra","fr","1137656","2502844","3640500"
2020,"18","New Zealand",":nz: New Zealand","nzl","nz","0","2964500","2964500"
2020,"19","Finland",":fi: Finland","fin","fi","0","2759382","2759382"
2020,"20","Korea, Republic of",":kr: Korea, Republic of","kor","kr","200000","1970636","2170636"
2020,"21","United Arab Emirates",":ae: United Arab Emirates","are","ae","500000","1500000","2000000"
2020,"22","Austria",":at: Austria","aut","at","1213592","103409","1317001"
2020,"23","Russian Federation",":ru: Russian Federation","rus","ru","0","1000000","1000000"
2020,"24","Luxembourg",":lu: Luxembourg","lux","lu","108578","868622","977200"
2020,"25","Poland",":pl: Poland","pol","pl","779266","0","779266"
2020,"26","Italy",":it: Italy","ita","it","723625","0","723625"
2020,"27","Estonia",":ee: Estonia","est","ee","413305","165563","578868"
2020,"28","Saudi Arabia",":sa: Saudi Arabia","sau","sa","0","500000","500000"
2020,"28","Türkiye",":tr: Türkiye","tur","tr","0","500000","500000"
2020,"30","Iceland",":is: Iceland","isl","is","0","499950","499950"
2020,"31","Romania",":ro: Romania","rou","ro","298685","0","298685"
2020,"32","Greece",":gr: Greece","grc","gr","220751","0","220751"
2020,"33","Private Contributions","Private Contributions","pri_con","","78637","0","78637"
2020,"34","Portugal",":pt: Portugal","prt","pt","46784","0","46784"
2020,"35","Monaco",":mc: Monaco","mco","mc","0","32967","32967"
2020,"36","Malta",":mt: Malta","mlt","mt","27293","0","27293"
2020,"37","Latvia",":lv: Latvia","lva","lv","23894","0","23894"
2020,"38","Singapore",":sg: Singapore","sgp","sg","0","19975","19975"
2020,"39","Malaysia",":my: Malaysia","mys","my","15000","0","15000"
2020,"40","Kazakhstan",":kz: Kazakhstan","kaz","kz","10000","0","10000"
2021,"1","United States",":us: United States","usa","us","46093620","3415602","49509222"
2021,"2","United Kingdom",":gb: United Kingdom","gbr","gb","3732927","34556169","38289096"
2021,"3","Sweden",":se: Sweden","swe","se","13181792","22161431","35343223"
2021,"4","Germany",":de: Germany","deu","de","20340073","5903484","26243557"
2021,"5","Norway",":no: Norway","nor","no","5050297","10533700","15583997"
2021,"6","European Commission","European Commission","eu","","14680315","0","14680315"
2021,"7","Canada",":ca: Canada","can","ca","10518065","1597610","12115675"
2021,"8","Denmark",":dk: Denmark","dnk","dk","0","11431415","11431415"
2021,"9","Saudi Arabia",":sa: Saudi Arabia","sau","sa","8734504","500000","9234504"
2021,"10","Netherlands",":nl: Netherlands","nld","nl","0","8474576","8474576"
2021,"11","Qatar",":qa: Qatar","qat","qa","0","7999985","7999985"
2021,"12","Australia",":au: Australia","aus","au","786864","7081776","7868640"
2021,"13","Belgium",":be: Belgium","bel","be","563063","7073171","7636234"
2021,"14","Switzerland",":ch: Switzerland","che","ch","4771001","2195390","6966391"
2021,"15","Japan",":jp: Japan","jpn","jp","5695000","614008","6309008"
2021,"16","France",":fr: France","fra","fr","2286585","3658537","5945122"
2021,"17","Ireland",":ie: Ireland","irl","ie","805194","3823178","4628372"
2021,"18","New Zealand",":nz: New Zealand","nzl","nz","0","3512500","3512500"
2021,"19","Finland",":fi: Finland","fin","fi","0","3033981","3033981"
2021,"20","Korea, Republic of",":kr: Korea, Republic of","kor","kr","0","2000000","2000000"
2021,"20","United Arab Emirates",":ae: United Arab Emirates","are","ae","500000","1500000","2000000"
2021,"22","Austria",":at: Austria","aut","at","1013514","108592","1122106"
2021,"23","Luxembourg",":lu: Luxembourg","lux","lu","121951","975610","1097561"
2021,"24","Russian Federation",":ru: Russian Federation","rus","ru","0","1000000","1000000"
2021,"25","Estonia",":ee: Estonia","est","ee","562707","179211","741918"
2021,"26","Poland",":pl: Poland","pol","pl","564810","0","564810"
2021,"27","Spain",":es: Spain","esp","es","563063","0","563063"
2021,"28","Türkiye",":tr: Türkiye","tur","tr","0","500000","500000"
2021,"28","Iceland",":is: Iceland","isl","is","0","500000","500000"
2021,"30","Greece",":gr: Greece","grc","gr","171645","0","171645"
2021,"31","Portugal",":pt: Portugal","prt","pt","84459","0","84459"
2021,"32","Jersey",":je: Jersey","jey","je","66489","0","66489"
2021,"33","Private Contributions","Private Contributions","pri_con","","50000","0","50000"
2021,"33","Mexico",":mx: Mexico","mex","mx","50000","0","50000"
2021,"35","Monaco",":mc: Monaco","mco","mc","0","36720","36720"
2021,"36","Singapore",":sg: Singapore","sgp","sg","0","19980","19980"
2021,"37","Azerbaijan",":az: Azerbaijan","aze","az","16667","0","16667"
2021,"38","Latvia",":lv: Latvia","lva","lv","11261","0","11261"
2021,"39","UN, NGOs and other entities","UN, NGOs and other entities","un","","10678","0","10678"
2021,"40","Malaysia",":my: Malaysia","mys","my","10000","0","10000"
2021,"40","Kazakhstan",":kz: Kazakhstan","kaz","kz","0","10000","10000"
2022,"1","United States",":us: United States","usa","us","61880000","3333413","65213413"
2022,"2","Sweden",":se: Sweden","swe","se","13273999","20244200","33518199"
2022,"3","United Kingdom",":gb: United Kingdom","gbr","gb","4427829","25703794","30131623"
2022,"4","Germany",":de: Germany","deu","de","20804811","4788295","25593106"
2022,"5","European Commission","European Commission","eu","","18892593","0","18892593"
2022,"6","Norway",":no: Norway","nor","no","6376166","10778183","17154349"
2022,"7","Canada",":ca: Canada","can","ca","10958638","1474916","12433554"
2022,"8","Denmark",":dk: Denmark","dnk","dk","0","10524783","10524783"
2022,"9","Netherlands",":nl: Netherlands","nld","nl","0","9782610","9782610"
2022,"10","Qatar",":qa: Qatar","qat","qa","0","7999970","7999970"
2022,"11","Ireland",":ie: Ireland","irl","ie","1723944","6063433","7787377"
2022,"12","Switzerland",":ch: Switzerland","che","ch","4168675","3538928","7707603"
2022,"13","Australia",":au: Australia","aus","au","722585","6503265","7225850"
2022,"14","Belgium",":be: Belgium","bel","be","259067","6473214","6732281"
2022,"15","France",":fr: France","fra","fr","1050420","3151261","4201681"
2022,"16","Japan",":jp: Japan","jpn","jp","3184673","614009","3798682"
2022,"17","New Zealand",":nz: New Zealand","nzl","nz","0","3143500","3143500"
2022,"18","Finland",":fi: Finland","fin","fi","0","2853881","2853881"
2022,"19","Spain",":es: Spain","esp","es","1757359","0","1757359"
2022,"20","Italy",":it: Italy","ita","it","527983","1028807","1556790"
2022,"21","Korea, Republic of",":kr: Korea, Republic of","kor","kr","200000","1000000","1200000"
2022,"22","Austria",":at: Austria","aut","at","1050420","104384","1154804"
2022,"23","Russian Federation",":ru: Russian Federation","rus","ru","0","1000000","1000000"
2022,"24","Iceland",":is: Iceland","isl","is","0","970013","970013"
2022,"25","Luxembourg",":lu: Luxembourg","lux","lu","107527","860215","967742"
2022,"26","Estonia",":ee: Estonia","est","ee","496221","179211","675432"
2022,"27","Poland",":pl: Poland","pol","pl","660296","0","660296"
2022,"28","Saudi Arabia",":sa: Saudi Arabia","sau","sa","0","500000","500000"
2022,"28","Türkiye",":tr: Türkiye","tur","tr","500000","0","500000"
2022,"30","Jersey",":je: Jersey","jey","je","256941","0","256941"
2022,"31","Slovenia",":si: Slovenia","svn","si","219058","0","219058"
2022,"32","Portugal",":pt: Portugal","prt","pt","158604","0","158604"
2022,"33","Latvia",":lv: Latvia","lva","lv","133929","0","133929"
2022,"34","Liechtenstein",":li: Liechtenstein","lie","li","108342","0","108342"
2022,"35","Malta",":mt: Malta","mlt","mt","100376","0","100376"
2022,"36","Bulgaria",":bg: Bulgaria","bgr","bg","52521","0","52521"
2022,"37","Cyprus",":cy: Cyprus","cyp","cy","0","42644","42644"
2022,"38","Monaco",":mc: Monaco","mco","mc","0","33708","33708"
2022,"39","Singapore",":sg: Singapore","sgp","sg","0","20000","20000"
2022,"40","UN, NGOs and other entities","UN, NGOs and other entities","un","","19747","0","19747"
2022,"41","Malaysia",":my: Malaysia","mys","my","10000","0","10000"
2022,"41","Kazakhstan",":kz: Kazakhstan","kaz","kz","0","10000","10000"
2023,"1","United States",":us: United States","usa","us","62008198","3421786","65429984"
2023,"2","United Kingdom",":gb: United Kingdom","gbr","gb","6316522","29612281","35928803"
2023,"3","Sweden",":se: Sweden","swe","se","15517782","14090337","29608119"
2023,"4","Germany",":de: Germany","deu","de","21756161","4824568","26580729"
2023,"5","European Commission","European Commission","eu","","17795457","0","17795457"
2023,"6","Norway",":no: Norway","nor","no","2271271","15422874","17694145"
2023,"7","Denmark",":dk: Denmark","dnk","dk","0","10483750","10483750"
2023,"8","Canada",":ca: Canada","can","ca","8823227","1512539","10335766"
2023,"9","Switzerland",":ch: Switzerland","che","ch","4856405","3739316","8595721"
2023,"10","Qatar",":qa: Qatar","qat","qa","0","8000000","8000000"
2023,"11","Netherlands",":nl: Netherlands","nld","nl","0","7494647","7494647"
2023,"12","Australia",":au: Australia","aus","au","696138","6265242","6961380"
2023,"13","Belgium",":be: Belgium","bel","be","274123","6318083","6592206"
2023,"14","Japan",":jp: Japan","jpn","jp","5653609","496608","6150217"
2023,"15","Spain",":es: Spain","esp","es","5763274","0","5763274"
2023,"16","Ireland",":ie: Ireland","irl","ie","492226","4817987","5310213"
2023,"17","France",":fr: France","fra","fr","0","3271538","3271538"
2023,"18","New Zealand",":nz: New Zealand","nzl","nz","0","3114000","3114000"
2023,"19","Finland",":fi: Finland","fin","fi","0","2744237","2744237"
2023,"20","Korea, Republic of",":kr: Korea, Republic of","kor","kr","1000000","1000000","2000000"
2023,"21","Luxembourg",":lu: Luxembourg","lux","lu","107066","1130054","1237120"
2023,"22","Austria",":at: Austria","aut","at","1084599","125821","1210420"
2023,"23","Portugal",":pt: Portugal","prt","pt","1078749","0","1078749"
2023,"24","Russian Federation",":ru: Russian Federation","rus","ru","0","950000","950000"
2023,"25","Iceland",":is: Iceland","isl","is","0","832120","832120"
2023,"26","Türkiye",":tr: Türkiye","tur","tr","200000","500000","700000"
2023,"27","Slovenia",":si: Slovenia","svn","si","636267","0","636267"
2023,"28","Estonia",":ee: Estonia","est","ee","346368","159915","506283"
2023,"29","Poland",":pl: Poland","pol","pl","500000","0","500000"
2023,"30","Cyprus",":cy: Cyprus","cyp","cy","331822","65678","397500"
2023,"31","Jersey",":je: Jersey","jey","je","243807","0","243807"
2023,"32","Lithuania",":lt: Lithuania","ltu","lt","214834","0","214834"
2023,"33","UN, NGOs and other entities","UN, NGOs and other entities","un","","83303","0","83303"
2023,"34","South Africa",":za: South Africa","zaf","za","0","69623","69623"
2023,"35","Greece",":gr: Greece","grc","gr","64240","0","64240"
2023,"36","Singapore",":sg: Singapore","sgp","sg","0","50000","50000"
2023,"37","Philippines",":ph: Philippines","phl","ph","45000","0","45000"
2023,"38","Monaco",":mc: Monaco","mco","mc","0","32120","32120"
2023,"39","Malta",":mt: Malta","mlt","mt","31881","0","31881"
2023,"40","Malaysia",":my: Malaysia","mys","my","10000","0","10000"
2023,"40","Kazakhstan",":kz: Kazakhstan","kaz","kz","10000","0","10000"
2023,"42","Private Contributions","Private Contributions","pri_con","","250","410","660"
2024,"1","United States",":us: United States","usa","us","59244131","3500000","62744131"
2024,"2","Sweden",":se: Sweden","swe","se","16130728","14134649","30265377"
2024,"3","United Kingdom",":gb: United Kingdom","gbr","gb","2105671","26843074","28948745"
2024,"4","Germany",":de: Germany","deu","de","19069319","5251163","24320482"
2024,"5","European Commission","European Commission","eu","","18908992","0","18908992"
2024,"6","Norway",":no: Norway","nor","no","466975","14492648","14959623"
2024,"7","Denmark",":dk: Denmark","dnk","dk","0","10030891","10030891"
2024,"8","Canada",":ca: Canada","can","ca","8455989","1477928","9933917"
2024,"9","Qatar",":qa: Qatar","qat","qa","873059","8000000","8873059"
2024,"10","Netherlands",":nl: Netherlands","nld","nl","0","7502680","7502680"
2024,"11","Australia",":au: Australia","aus","au","664608","5981478","6646086"
2024,"12","Belgium",":be: Belgium","bel","be","0","6223176","6223176"
2024,"13","Ireland",":ie: Ireland","irl","ie","218818","5952381","6171199"
2024,"14","Switzerland",":ch: Switzerland","che","ch","230898","5530973","5761871"
2024,"15","Japan",":jp: Japan","jpn","jp","3300000","0","3300000"
2024,"16","New Zealand",":nz: New Zealand","nzl","nz","0","3066500","3066500"
2024,"17","Finland",":fi: Finland","fin","fi","0","2735230","2735230"
2024,"18","Spain",":es: Spain","esp","es","2700246","0","2700246"
2024,"19","Saudi Arabia",":sa: Saudi Arabia","sau","sa","1499985","499993","1999978"
2024,"20","Poland",":pl: Poland","pol","pl","1500000","0","1500000"
2024,"21","Austria",":at: Austria","aut","at","1089325","270270","1359595"
2024,"22","Luxembourg",":lu: Luxembourg","lux","lu","109409","1149397","1258806"
2024,"23","France",":fr: France","fra","fr","0","1071811","1071811"
2024,"24","Private Contributions","Private Contributions","pri_con","","3925","1000000","1003925"
2024,"25","Korea, Republic of",":kr: Korea, Republic of","kor","kr","1000000","0","1000000"
2024,"26","Iceland",":is: Iceland","isl","is","0","874759","874759"
2024,"27","Estonia",":ee: Estonia","est","ee","605454","161812","767266"
2024,"28","Türkiye",":tr: Türkiye","tur","tr","525000","0","525000"
2024,"29","Portugal",":pt: Portugal","prt","pt","329683","0","329683"
2024,"30","Greece",":gr: Greece","grc","gr","270396","0","270396"
2024,"31","Jersey",":je: Jersey","jey","je","237552","0","237552"
2024,"32","South Africa",":za: South Africa","zaf","za","0","167603","167603"
2024,"33","Cyprus",":cy: Cyprus","cyp","cy","107182","0","107182"
2024,"34","UN, NGOs and other entities","UN, NGOs and other entities","un","","52858","0","52858"
2024,"35","Singapore",":sg: Singapore","sgp","sg","0","50000","50000"
2024,"36","Malta",":mt: Malta","mlt","mt","43384","0","43384"
2024,"37","Philippines",":ph: Philippines","phl","ph","35000","0","35000"
2024,"38","Monaco",":mc: Monaco","mco","mc","0","32432","32432"
2024,"39","Latvia",":lv: Latvia","lva","lv","10799","0","10799"
